{
  "size": 13,
  "templates": {
    "U_big": [
      1, 1, 1, 1, 1, 1, 7, 1, 1, 1, 1, 1, 1,
      1, 0, 0, 0, 0, 0, 0, 0, 0, 0, 0, 0, 1,
      1, 0, 8, 0, 0, 0, 0, 0, 0, 0, 8, 0, 1,
      1, 0, 0, 0, 0, 0, 0, 0, 0, 0, 0, 0, 1,
      1, 0, 0, 0, 0, 0, 8, 0, 0, 0, 0, 0, 1,
      1, 0, 0, 0, 0, 9, 0, 9, 0, 0, 0, 0, 1,
      1, 0, 0, 0, 8, 0, 9, 0, 8, 0, 0, 0, 1,
      1, 0, 0, 0, 0, 9, 0, 9, 0, 0, 0, 0, 1,
      1, 0, 0, 0, 0, 0, 8, 0, 0, 0, 0, 0, 1,
      1, 0, 0, 0, 0, 0, 0, 0, 0, 0, 0, 0, 1,
      1, 0, 8, 0, 0, 0, 0, 0, 0, 0, 8, 0, 1,
      1, 0, 0, 0, 0, 0, 0, 0, 0, 0, 0, 0, 1,
      1, 1, 1, 1, 1, 1, 1, 1, 1, 1, 1, 1, 1
    ],
    "I_big": [
      1, 1, 1, 1, 1, 1, 0, 1, 1, 1, 1, 1, 1,
      1, 0, 0, 0, 0, 0, 0, 0, 0, 0, 0, 0, 1,
      1, 0, 8, 0, 0, 0, 0, 0, 0, 0, 8, 0, 1,
      1, 0, 0, 0, 0, 0, 0, 0, 0, 0, 0, 0, 1,
      1, 0, 0, 0, 0, 0, 8, 0, 0, 0, 0, 0, 1,
      1, 0, 0, 0, 0, 9, 0, 9, 0, 0, 0, 0, 1,
      1, 0, 0, 0, 8, 0, 9, 0, 8, 0, 0, 0, 1,
      1, 0, 0, 0, 0, 9, 0, 9, 0, 0, 0, 0, 1,
      1, 0, 0, 0, 0, 0, 8, 0, 0, 0, 0, 0, 1,
      1, 0, 0, 0, 0, 0, 0, 0, 0, 0, 0, 0, 1,
      1, 0, 8, 0, 0, 0, 0, 0, 0, 0, 8, 0, 1,
      1, 0, 0, 0, 0, 0, 0, 0, 0, 0, 0, 0, 1,
      1, 1, 1, 1, 1, 1, 0, 1, 1, 1, 1, 1, 1
    ],
    "L_big": [
      1, 1, 1, 1, 1, 1, 0, 1, 1, 1, 1, 1, 1,
      1, 0, 0, 0, 0, 0, 0, 0, 0, 0, 0, 0, 1,
      1, 0, 8, 0, 0, 0, 0, 0, 0, 0, 8, 0, 1,
      1, 0, 0, 0, 0, 0, 0, 0, 0, 0, 0, 0, 1,
      1, 0, 0, 0, 0, 0, 8, 0, 0, 0, 0, 0, 1,
      1, 0, 0, 0, 0, 9, 0, 9, 0, 0, 0, 0, 1,
      1, 0, 0, 0, 8, 0, 9, 0, 0, 0, 0, 0, 0,
      1, 0, 0, 0, 0, 9, 0, 9, 0, 0, 0, 0, 1,
      1, 0, 0, 0, 0, 0, 8, 0, 0, 0, 0, 0, 1,
      1, 0, 0, 0, 0, 0, 0, 0, 0, 0, 0, 0, 1,
      1, 0, 8, 0, 0, 0, 0, 0, 0, 0, 8, 0, 1,
      1, 0, 0, 0, 0, 0, 9, 0, 0, 0, 0, 0, 1,
      1, 1, 1, 1, 1, 1, 1, 1, 1, 1, 1, 1, 1
    ],
    "T_big": [
      1, 1, 1, 1, 1, 1, 1, 1, 1, 1, 1, 1, 1,
      1, 0, 0, 0, 0, 0, 0, 0, 0, 0, 0, 0, 1,
      1, 0, 8, 0, 0, 0, 0, 0, 0, 0, 8, 0, 1,
      1, 0, 0, 0, 0, 0, 0, 0, 0, 0, 0, 0, 1,
      1, 0, 0, 0, 0, 0, 8, 0, 0, 0, 0, 0, 1,
      1, 0, 0, 0, 0, 9, 0, 9, 0, 0, 0, 0, 1,
      0, 0, 0, 0, 8, 0, 9, 0, 8, 0, 0, 0, 0,
      1, 0, 0, 0, 0, 9, 0, 9, 0, 0, 0, 0, 1,
      1, 0, 0, 0, 0, 0, 8, 0, 0, 0, 0, 0, 1,
      1, 0, 0, 0, 0, 0, 0, 0, 0, 0, 0, 0, 1,
      1, 0, 8, 0, 0, 0, 0, 0, 0, 0, 8, 0, 1,
      1, 0, 0, 0, 0, 0, 0, 0, 0, 0, 0, 0, 1,
      1, 1, 1, 1, 1, 1, 0, 1, 1, 1, 1, 1, 1
    ],
    "X_big": [
      1, 1, 1, 1, 1, 1, 0, 1, 1, 1, 1, 1, 1,
      1, 0, 0, 0, 0, 0, 0, 0, 0, 0, 0, 0, 1,
      1, 0, 8, 0, 0, 0, 0, 0, 0, 0, 8, 0, 1,
      1, 0, 0, 0, 0, 0, 0, 0, 0, 0, 0, 0, 1,
      1, 0, 0, 0, 0, 0, 8, 0, 0, 0, 0, 0, 1,
      1, 0, 0, 0, 0, 9, 0, 9, 0, 0, 0, 0, 1,
      0, 0, 0, 0, 8, 0, 9, 0, 8, 0, 0, 0, 0,
      1, 0, 0, 0, 0, 9, 0, 9, 0, 0, 0, 0, 1,
      1, 0, 0, 0, 0, 0, 8, 0, 0, 0, 0, 0, 1,
      1, 0, 0, 0, 0, 0, 0, 0, 0, 0, 0, 0, 1,
      1, 0, 8, 0, 0, 0, 0, 0, 0, 0, 8, 0, 1,
      1, 0, 0, 0, 0, 0, 0, 0, 0, 0, 0, 0, 1,
      1, 1, 1, 1, 1, 1, 0, 1, 1, 1, 1, 1, 1
    ],

    "U_circle": [
      1, 1, 1, 1, 1, 1, 7, 1, 1, 1, 1, 1, 1,
      1, 1, 1, 1, 0, 0, 0, 0, 0, 1, 1, 1, 1,
      1, 1, 1, 0, 0, 0, 0, 0, 0, 0, 1, 1, 1,
      1, 1, 0, 0, 0, 0, 8, 0, 0, 0, 0, 1, 1,
      1, 0, 0, 0, 0, 0, 0, 0, 0, 0, 0, 0, 1,
      1, 0, 8, 0, 0, 8, 0, 8, 0, 0, 8, 0, 1,
      1, 0, 0, 0, 0, 0, 9, 0, 0, 0, 0, 0, 1,
      1, 0, 8, 0, 0, 8, 0, 8, 0, 0, 8, 0, 1,
      1, 0, 0, 0, 0, 0, 0, 0, 0, 0, 0, 0, 1,
      1, 1, 0, 0, 0, 0, 8, 0, 0, 0, 0, 1, 1,
      1, 1, 1, 9, 0, 0, 0, 0, 0, 9, 1, 1, 1,
      1, 1, 1, 1, 0, 0, 9, 0, 0, 1, 1, 1, 1,
      1, 1, 1, 1, 1, 1, 1, 1, 1, 1, 1, 1, 1
    ],

    "U_diamond": [
      1, 1, 1, 1, 1, 1, 7, 1, 1, 1, 1, 1, 1,
      1, 1, 1, 1, 1, 1, 0, 1, 1, 1, 1, 1, 1,
      1, 1, 1, 1, 1, 0, 0, 0, 1, 1, 1, 1, 1,
      1, 1, 1, 1, 0, 0, 0, 0, 0, 1, 1, 1, 1,
      1, 1, 1, 0, 0, 0, 0, 0, 0, 0, 1, 1, 1,
      1, 1, 0, 0, 0, 8, 0, 8, 0, 0, 0, 1, 1,
      1, 9, 0, 8, 0, 0, 9, 0, 0, 8, 0, 9, 1,
      1, 1, 0, 0, 0, 8, 0, 8, 0, 0, 0, 1, 1,
      1, 1, 1, 0, 0, 0, 0, 0, 0, 0, 1, 1, 1,
      1, 1, 1, 1, 0, 0, 8, 0, 0, 1, 1, 1, 1,
      1, 1, 1, 1, 1, 0, 0, 0, 1, 1, 1, 1, 1,
      1, 1, 1, 1, 1, 1, 9, 1, 1, 1, 1, 1, 1,
      1, 1, 1, 1, 1, 1, 1, 1, 1, 1, 1, 1, 1
    ],

    "U_cubby": [
      1, 1, 1, 1, 1, 1, 7, 1, 1, 1, 1, 1, 1,
      1, 0, 0, 0, 0, 0, 0, 0, 0, 0, 0, 0, 1,
      1, 0, 0, 0, 0, 0, 0, 0, 0, 0, 0, 0, 1,
      1, 0, 0, 1, 1, 1, 1, 1, 1, 1, 0, 0, 1,
      1, 0, 0, 1, 1, 1, 1, 1, 1, 1, 0, 0, 1,
      1, 0, 0, 1, 1, 0, 9, 0, 1, 1, 0, 0, 1,
      1, 0, 0, 1, 1, 0, 0, 0, 1, 1, 0, 0, 1,
      1, 0, 0, 1, 1, 9, 0, 9, 1, 1, 0, 0, 1,
      1, 0, 0, 1, 1, 0, 8, 0, 1, 1, 0, 0, 1,
      1, 0, 0, 1, 1, 8, 0, 8, 1, 1, 0, 0, 1,
      1, 8, 0, 0, 0, 0, 0, 0, 0, 0, 0, 8, 1,
      1, 0, 0, 0, 8, 0, 0, 0, 8, 0, 0, 0, 1,
      1, 1, 1, 1, 1, 1, 1, 1, 1, 1, 1, 1, 1
    ],

    "U_tiny": [
      1, 1, 1, 1, 1, 1, 0, 1, 1, 1, 1, 1, 1,
      1, 1, 1, 1, 1, 1, 0, 1, 1, 1, 1, 1, 1,
      1, 1, 1, 1, 1, 1, 0, 1, 1, 1, 1, 1, 1,
      1, 1, 1, 1, 1, 1, 0, 1, 1, 1, 1, 1, 1,
      1, 1, 1, 1, 1, 1, 0, 1, 1, 1, 1, 1, 1,
      1, 1, 1, 1, 1, 8, 0, 8, 1, 1, 1, 1, 1,
      1, 1, 1, 1, 1, 0, 9, 0, 1, 1, 1, 1, 1,
      1, 1, 1, 1, 1, 0, 0, 0, 1, 1, 1, 1, 1,
      1, 1, 1, 1, 1, 1, 1, 1, 1, 1, 1, 1, 1,
      1, 1, 1, 1, 1, 1, 1, 1, 1, 1, 1, 1, 1,
      1, 1, 1, 1, 1, 1, 1, 1, 1, 1, 1, 1, 1,
      1, 1, 1, 1, 1, 1, 1, 1, 1, 1, 1, 1, 1,
      1, 1, 1, 1, 1, 1, 1, 1, 1, 1, 1, 1, 1
    ],
    "I_tiny": [
      1, 1, 1, 1, 1, 1, 0, 1, 1, 1, 1, 1, 1,
      1, 1, 1, 1, 1, 1, 0, 1, 1, 1, 1, 1, 1,
      1, 1, 1, 1, 1, 1, 0, 1, 1, 1, 1, 1, 1,
      1, 1, 1, 1, 1, 1, 0, 1, 1, 1, 1, 1, 1,
      1, 1, 1, 1, 1, 1, 0, 1, 1, 1, 1, 1, 1,
      1, 1, 1, 1, 1, 8, 0, 0, 1, 1, 1, 1, 1,
      1, 1, 1, 1, 1, 0, 9, 0, 1, 1, 1, 1, 1,
      1, 1, 1, 1, 1, 0, 0, 8, 1, 1, 1, 1, 1,
      1, 1, 1, 1, 1, 1, 0, 1, 1, 1, 1, 1, 1,
      1, 1, 1, 1, 1, 1, 0, 1, 1, 1, 1, 1, 1,
      1, 1, 1, 1, 1, 1, 0, 1, 1, 1, 1, 1, 1,
      1, 1, 1, 1, 1, 1, 0, 1, 1, 1, 1, 1, 1,
      1, 1, 1, 1, 1, 1, 0, 1, 1, 1, 1, 1, 1
    ],
    "L_tiny": [
      1, 1, 1, 1, 1, 1, 0, 1, 1, 1, 1, 1, 1,
      1, 1, 1, 1, 1, 1, 0, 1, 1, 1, 1, 1, 1,
      1, 1, 1, 1, 1, 1, 0, 1, 1, 1, 1, 1, 1,
      1, 1, 1, 1, 1, 1, 0, 1, 1, 1, 1, 1, 1,
      1, 1, 1, 1, 1, 1, 0, 1, 1, 1, 1, 1, 1,
      1, 1, 1, 1, 1, 8, 0, 0, 1, 1, 1, 1, 1,
      1, 1, 1, 1, 1, 0, 0, 0, 0, 0, 0, 0, 0,
      1, 1, 1, 1, 1, 9, 0, 8, 1, 1, 1, 1, 1,
      1, 1, 1, 1, 1, 1, 1, 1, 1, 1, 1, 1, 1,
      1, 1, 1, 1, 1, 1, 1, 1, 1, 1, 1, 1, 1,
      1, 1, 1, 1, 1, 1, 1, 1, 1, 1, 1, 1, 1,
      1, 1, 1, 1, 1, 1, 1, 1, 1, 1, 1, 1, 1,
      1, 1, 1, 1, 1, 1, 1, 1, 1, 1, 1, 1, 1
    ],
    "T_tiny": [
      1, 1, 1, 1, 1, 1, 1, 1, 1, 1, 1, 1, 1,
      1, 1, 1, 1, 1, 1, 1, 1, 1, 1, 1, 1, 1,
      1, 1, 1, 1, 1, 1, 1, 1, 1, 1, 1, 1, 1,
      1, 1, 1, 1, 1, 1, 1, 1, 1, 1, 1, 1, 1,
      1, 1, 1, 1, 1, 1, 1, 1, 1, 1, 1, 1, 1,
      1, 1, 1, 1, 1, 0, 9, 0, 1, 1, 1, 1, 1,
      0, 0, 0, 0, 0, 8, 0, 8, 0, 0, 0, 0, 0,
      1, 1, 1, 1, 1, 0, 0, 0, 1, 1, 1, 1, 1,
      1, 1, 1, 1, 1, 1, 0, 1, 1, 1, 1, 1, 1,
      1, 1, 1, 1, 1, 1, 0, 1, 1, 1, 1, 1, 1,
      1, 1, 1, 1, 1, 1, 0, 1, 1, 1, 1, 1, 1,
      1, 1, 1, 1, 1, 1, 0, 1, 1, 1, 1, 1, 1,
      1, 1, 1, 1, 1, 1, 0, 1, 1, 1, 1, 1, 1
    ],
    "X_tiny": [
      1, 1, 1, 1, 1, 1, 0, 1, 1, 1, 1, 1, 1,
      1, 1, 1, 1, 1, 1, 0, 1, 1, 1, 1, 1, 1,
      1, 1, 1, 1, 1, 1, 0, 1, 1, 1, 1, 1, 1,
      1, 1, 1, 1, 1, 1, 0, 1, 1, 1, 1, 1, 1,
      1, 1, 1, 1, 1, 1, 0, 1, 1, 1, 1, 1, 1,
      1, 1, 1, 1, 1, 0, 0, 8, 1, 1, 1, 1, 1,
      0, 0, 0, 0, 0, 0, 9, 0, 0, 0, 0, 0, 0,
      1, 1, 1, 1, 1, 8, 0, 0, 1, 1, 1, 1, 1,
      1, 1, 1, 1, 1, 1, 0, 1, 1, 1, 1, 1, 1,
      1, 1, 1, 1, 1, 1, 0, 1, 1, 1, 1, 1, 1,
      1, 1, 1, 1, 1, 1, 0, 1, 1, 1, 1, 1, 1,
      1, 1, 1, 1, 1, 1, 0, 1, 1, 1, 1, 1, 1,
      1, 1, 1, 1, 1, 1, 0, 1, 1, 1, 1, 1, 1
    ],

    "U_cozy": [
      1, 1, 1, 1, 1, 1, 0, 1, 1, 1, 1, 1, 1,
      1, 1, 1, 1, 1, 1, 0, 1, 1, 1, 1, 1, 1,
      1, 1, 1, 1, 1, 1, 0, 1, 1, 1, 1, 1, 1,
      1, 1, 1, 1, 0, 0, 0, 0, 0, 1, 1, 1, 1,
      1, 1, 1, 0, 8, 0, 0, 0, 8, 0, 1, 1, 1,
      1, 1, 1, 0, 0, 0, 0, 0, 0, 0, 1, 1, 1,
      1, 1, 1, 0, 8, 0, 0, 0, 8, 0, 1, 1, 1,
      1, 1, 1, 0, 0, 9, 0, 9, 0, 0, 1, 1, 1,
      1, 1, 1, 8, 0, 0, 8, 0, 0, 8, 1, 1, 1,
      1, 1, 1, 1, 9, 0, 0, 0, 9, 1, 1, 1, 1,
      1, 1, 1, 1, 1, 1, 1, 1, 1, 1, 1, 1, 1,
      1, 1, 1, 1, 1, 1, 1, 1, 1, 1, 1, 1, 1,
      1, 1, 1, 1, 1, 1, 1, 1, 1, 1, 1, 1, 1
    ],
    "I_cozy": [
      1, 1, 1, 1, 1, 1, 0, 1, 1, 1, 1, 1, 1,
      1, 1, 1, 1, 1, 1, 0, 1, 1, 1, 1, 1, 1,
      1, 1, 1, 1, 1, 1, 0, 1, 1, 1, 1, 1, 1,
      1, 1, 1, 1, 0, 0, 0, 0, 0, 1, 1, 1, 1,
      1, 1, 1, 9, 0, 0, 8, 0, 0, 9, 1, 1, 1,
      1, 1, 1, 0, 0, 0, 0, 0, 0, 0, 1, 1, 1,
      1, 1, 1, 0, 8, 0, 8, 0, 8, 0, 1, 1, 1,
      1, 1, 1, 0, 0, 0, 0, 0, 0, 0, 1, 1, 1,
      1, 1, 1, 9, 0, 0, 8, 0, 0, 9, 1, 1, 1,
      1, 1, 1, 1, 0, 0, 0, 0, 0, 1, 1, 1, 1,
      1, 1, 1, 1, 1, 1, 0, 1, 1, 1, 1, 1, 1,
      1, 1, 1, 1, 1, 1, 0, 1, 1, 1, 1, 1, 1,
      1, 1, 1, 1, 1, 1, 0, 1, 1, 1, 1, 1, 1
    ],
    "L_cozy": [
      1, 1, 1, 1, 1, 1, 0, 1, 1, 1, 1, 1, 1,
      1, 1, 1, 1, 1, 1, 0, 1, 1, 1, 1, 1, 1,
      1, 1, 1, 1, 1, 1, 0, 1, 1, 1, 1, 1, 1,
      1, 1, 1, 1, 0, 0, 0, 0, 0, 1, 1, 1, 1,
      1, 1, 1, 9, 0, 0, 0, 0, 8, 0, 1, 1, 1,
      1, 1, 1, 0, 0, 8, 0, 0, 0, 0, 1, 1, 1,
      1, 1, 1, 8, 0, 0, 0, 0, 0, 0, 0, 0, 0,
      1, 1, 1, 0, 0, 8, 0, 8, 0, 0, 1, 1, 1,
      1, 1, 1, 9, 0, 0, 0, 0, 0, 0, 1, 1, 1,
      1, 1, 1, 1, 9, 0, 8, 0, 9, 1, 1, 1, 1,
      1, 1, 1, 1, 1, 1, 1, 1, 1, 1, 1, 1, 1,
      1, 1, 1, 1, 1, 1, 1, 1, 1, 1, 1, 1, 1,
      1, 1, 1, 1, 1, 1, 1, 1, 1, 1, 1, 1, 1
    ],
    "T_cozy": [
      1, 1, 1, 1, 1, 1, 1, 1, 1, 1, 1, 1, 1,
      1, 1, 1, 1, 1, 1, 1, 1, 1, 1, 1, 1, 1,
      1, 1, 1, 1, 1, 1, 1, 1, 1, 1, 1, 1, 1,
      1, 1, 1, 1, 9, 0, 9, 0, 9, 1, 1, 1, 1,
      1, 1, 1, 0, 0, 8, 0, 8, 0, 0, 1, 1, 1,
      1, 1, 1, 0, 8, 0, 0, 0, 8, 0, 1, 1, 1,
      0, 0, 0, 0, 0, 0, 9, 0, 0, 0, 0, 0, 0,
      1, 1, 1, 0, 8, 0, 0, 0, 8, 0, 1, 1, 1,
      1, 1, 1, 0, 0, 0, 0, 0, 0, 0, 1, 1, 1,
      1, 1, 1, 1, 0, 0, 0, 0, 0, 1, 1, 1, 1,
      1, 1, 1, 1, 1, 1, 0, 1, 1, 1, 1, 1, 1,
      1, 1, 1, 1, 1, 1, 0, 1, 1, 1, 1, 1, 1,
      1, 1, 1, 1, 1, 1, 0, 1, 1, 1, 1, 1, 1
    ],
    "X_cozy": [
      1, 1, 1, 1, 1, 1, 0, 1, 1, 1, 1, 1, 1,
      1, 1, 1, 1, 1, 1, 0, 1, 1, 1, 1, 1, 1,
      1, 1, 1, 1, 1, 1, 0, 1, 1, 1, 1, 1, 1,
      1, 1, 1, 1, 0, 0, 0, 0, 0, 1, 1, 1, 1,
      1, 1, 1, 9, 0, 0, 8, 0, 0, 9, 1, 1, 1,
      1, 1, 1, 0, 0, 8, 0, 8, 0, 0, 1, 1, 1,
      0, 0, 0, 0, 8, 0, 9, 0, 8, 0, 0, 0, 0,
      1, 1, 1, 0, 0, 8, 0, 8, 0, 0, 1, 1, 1,
      1, 1, 1, 9, 0, 0, 8, 0, 0, 9, 1, 1, 1,
      1, 1, 1, 1, 0, 0, 0, 0, 0, 1, 1, 1, 1,
      1, 1, 1, 1, 1, 1, 0, 1, 1, 1, 1, 1, 1,
      1, 1, 1, 1, 1, 1, 0, 1, 1, 1, 1, 1, 1,
      1, 1, 1, 1, 1, 1, 0, 1, 1, 1, 1, 1, 1
    ],

    "I_hallway": [
      1, 1, 1, 1, 1, 1, 0, 1, 1, 1, 1, 1, 1,
      1, 1, 1, 1, 1, 1, 0, 1, 1, 1, 1, 1, 1,
      1, 1, 1, 1, 1, 1, 0, 1, 1, 1, 1, 1, 1,
      1, 1, 1, 1, 1, 1, 0, 1, 1, 1, 1, 1, 1,
      1, 1, 1, 1, 1, 1, 0, 1, 1, 1, 1, 1, 1,
      1, 1, 1, 1, 1, 1, 0, 1, 1, 1, 1, 1, 1,
      1, 1, 1, 1, 1, 1, 8, 1, 1, 1, 1, 1, 1,
      1, 1, 1, 1, 1, 1, 0, 1, 1, 1, 1, 1, 1,
      1, 1, 1, 1, 1, 1, 0, 1, 1, 1, 1, 1, 1,
      1, 1, 1, 1, 1, 1, 0, 1, 1, 1, 1, 1, 1,
      1, 1, 1, 1, 1, 1, 0, 1, 1, 1, 1, 1, 1,
      1, 1, 1, 1, 1, 1, 0, 1, 1, 1, 1, 1, 1,
      1, 1, 1, 1, 1, 1, 0, 1, 1, 1, 1, 1, 1
    ],
    "L_hallway": [
      1, 1, 1, 1, 1, 1, 0, 1, 1, 1, 1, 1, 1,
      1, 1, 1, 1, 1, 1, 0, 1, 1, 1, 1, 1, 1,
      1, 1, 1, 1, 1, 1, 0, 1, 1, 1, 1, 1, 1,
      1, 1, 1, 1, 1, 1, 0, 1, 1, 1, 1, 1, 1,
      1, 1, 1, 1, 1, 1, 0, 1, 1, 1, 1, 1, 1,
      1, 1, 1, 1, 1, 1, 0, 1, 1, 1, 1, 1, 1,
      1, 1, 1, 1, 1, 1, 8, 0, 0, 0, 0, 0, 0,
      1, 1, 1, 1, 1, 1, 1, 1, 1, 1, 1, 1, 1,
      1, 1, 1, 1, 1, 1, 1, 1, 1, 1, 1, 1, 1,
      1, 1, 1, 1, 1, 1, 1, 1, 1, 1, 1, 1, 1,
      1, 1, 1, 1, 1, 1, 1, 1, 1, 1, 1, 1, 1,
      1, 1, 1, 1, 1, 1, 1, 1, 1, 1, 1, 1, 1,
      1, 1, 1, 1, 1, 1, 1, 1, 1, 1, 1, 1, 1
    ],
    "T_hallway": [
      1, 1, 1, 1, 1, 1, 1, 1, 1, 1, 1, 1, 1,
      1, 1, 1, 1, 1, 1, 1, 1, 1, 1, 1, 1, 1,
      1, 1, 1, 1, 1, 1, 1, 1, 1, 1, 1, 1, 1,
      1, 1, 1, 1, 1, 1, 1, 1, 1, 1, 1, 1, 1,
      1, 1, 1, 1, 1, 1, 1, 1, 1, 1, 1, 1, 1,
      1, 1, 1, 1, 1, 1, 1, 1, 1, 1, 1, 1, 1,
      0, 0, 0, 0, 0, 0, 8, 0, 0, 0, 0, 0, 0,
      1, 1, 1, 1, 1, 1, 0, 1, 1, 1, 1, 1, 1,
      1, 1, 1, 1, 1, 1, 0, 1, 1, 1, 1, 1, 1,
      1, 1, 1, 1, 1, 1, 0, 1, 1, 1, 1, 1, 1,
      1, 1, 1, 1, 1, 1, 0, 1, 1, 1, 1, 1, 1,
      1, 1, 1, 1, 1, 1, 0, 1, 1, 1, 1, 1, 1,
      1, 1, 1, 1, 1, 1, 0, 1, 1, 1, 1, 1, 1
    ],
    "X_hallway": [
      1, 1, 1, 1, 1, 1, 0, 1, 1, 1, 1, 1, 1,
      1, 1, 1, 1, 1, 1, 0, 1, 1, 1, 1, 1, 1,
      1, 1, 1, 1, 1, 1, 0, 1, 1, 1, 1, 1, 1,
      1, 1, 1, 1, 1, 1, 0, 1, 1, 1, 1, 1, 1,
      1, 1, 1, 1, 1, 1, 0, 1, 1, 1, 1, 1, 1,
      1, 1, 1, 1, 1, 1, 0, 1, 1, 1, 1, 1, 1,
      0, 0, 0, 0, 0, 0, 8, 0, 0, 0, 0, 0, 0,
      1, 1, 1, 1, 1, 1, 0, 1, 1, 1, 1, 1, 1,
      1, 1, 1, 1, 1, 1, 0, 1, 1, 1, 1, 1, 1,
      1, 1, 1, 1, 1, 1, 0, 1, 1, 1, 1, 1, 1,
      1, 1, 1, 1, 1, 1, 0, 1, 1, 1, 1, 1, 1,
      1, 1, 1, 1, 1, 1, 0, 1, 1, 1, 1, 1, 1,
      1, 1, 1, 1, 1, 1, 0, 1, 1, 1, 1, 1, 1
    ],

    "I_enclave": [
      1, 1, 1, 1, 1, 1, 0, 1, 1, 1, 1, 1, 1,
      1, 1, 1, 1, 1, 1, 0, 1, 1, 1, 1, 1, 1,
      1, 1, 8, 0, 0, 0, 0, 0, 0, 0, 8, 1, 1,
      1, 1, 0, 1, 1, 1, 1, 1, 1, 1, 0, 1, 1,
      1, 1, 0, 1, 1, 1, 1, 1, 1, 1, 0, 1, 1,
      1, 1, 0, 1, 1, 9, 0, 9, 1, 1, 0, 1, 1,
      1, 1, 8, 0, 0, 0, 8, 0, 0, 0, 8, 1, 1,
      1, 1, 0, 1, 1, 9, 0, 9, 1, 1, 0, 1, 1,
      1, 1, 0, 1, 1, 1, 1, 1, 1, 1, 0, 1, 1,
      1, 1, 0, 1, 1, 1, 1, 1, 1, 1, 0, 1, 1,
      1, 1, 8, 0, 0, 0, 0, 0, 0, 0, 8, 1, 1,
      1, 1, 1, 1, 1, 1, 0, 1, 1, 1, 1, 1, 1,
      1, 1, 1, 1, 1, 1, 0, 1, 1, 1, 1, 1, 1
    ],

    "I_zig": [
      1, 1, 1, 1, 1, 1, 0, 1, 1, 1, 1, 1, 1,
      1, 1, 1, 1, 1, 1, 0, 1, 1, 1, 1, 1, 1,
      1, 1, 1, 1, 0, 0, 0, 1, 1, 1, 1, 1, 1,
      1, 1, 9, 0, 8, 0, 0, 1, 1, 1, 1, 1, 1,
      1, 1, 1, 1, 0, 0, 0, 1, 1, 1, 1, 1, 1,
      1, 1, 1, 1, 1, 1, 0, 0, 0, 1, 1, 1, 1,
      1, 1, 1, 1, 1, 1, 0, 8, 0, 0, 9, 1, 1,
      1, 1, 1, 1, 1, 1, 0, 0, 0, 1, 1, 1, 1,
      1, 1, 1, 1, 0, 0, 0, 1, 1, 1, 1, 1, 1,
      1, 1, 9, 0, 0, 8, 0, 1, 1, 1, 1, 1, 1,
      1, 1, 1, 1, 0, 0, 0, 1, 1, 1, 1, 1, 1,
      1, 1, 1, 1, 1, 1, 0, 1, 1, 1, 1, 1, 1,
      1, 1, 1, 1, 1, 1, 0, 1, 1, 1, 1, 1, 1
    ],

    "L_maze": [
      1, 1, 1, 1, 1, 1, 0, 1, 1, 1, 1, 1, 1,
      1, 1, 1, 1, 1, 1, 0, 1, 1, 1, 1, 1, 1,
      1, 1, 8, 0, 0, 0, 0, 1, 1, 9, 9, 1, 1,
      1, 1, 0, 1, 1, 1, 0, 1, 1, 0, 0, 1, 1,
      1, 1, 0, 1, 1, 1, 0, 1, 1, 8, 8, 1, 1,
      1, 1, 0, 9, 1, 1, 0, 1, 1, 0, 0, 1, 1,
      1, 1, 0, 1, 1, 1, 0, 0, 0, 0, 0, 0, 0,
      1, 1, 0, 1, 1, 1, 1, 1, 1, 0, 0, 1, 1,
      1, 1, 0, 1, 1, 1, 1, 1, 1, 0, 0, 1, 1,
      1, 1, 0, 1, 1, 1, 9, 1, 1, 0, 0, 1, 1,
      1, 1, 8, 0, 0, 0, 0, 0, 0, 0, 8, 1, 1,
      1, 1, 1, 1, 1, 1, 1, 1, 1, 1, 1, 1, 1,
      1, 1, 1, 1, 1, 1, 1, 1, 1, 1, 1, 1, 1
    ]

  }
}
